..#..........
..#......ww..
..#.....wwww.
..#..........
..########...
....#....#...
....#....####
..ww####.....
...ww..#.....
.......#.....
