..*...........
..#......ww...
..#.....wwww..
..#...........
..########....
....#....#....
....#....#####
..ww####......
...ww..#......
.......#......
